SO ./img/north_texture.xpm
WE ./img/west_texture.xpm

EA ./img/east_texture.xpm
NO ./img/south_texture.xpm



C 205,249,255
F 157,157,157


1111111111111111111111111
1000000000110000000000001
101100000111000000000000111111111
110010000000000000000000011111111
101111111011000001110000000000001
100000000011000001110111110111111
11110111111111011100000010001
11110111111111011101010010001
11000000110101011100000010001
10000000000000001100000010001
10000000000000001101010010001
11000001110101011111011010S01
11110111 1110101 101111110011
11111111 1111111 111111111111