SO ./img/south_texture.xpm
WE ./img/west_texture.xpm

EA ./img/east_texture.xpm
NO ./img/north_texture.xpm



C 205,249,255
F 157,157,157


    1111111111111111111111111
    10000000001100000000000011
    10110000011100000000000001
    11111111101100000111000000001
111111001000000000000000000001
10N00000001100000111011111111111
11110111111111011100000010001
11110111111111011101010010001
11000000110101011100000010001
10000000000000000000000011001
10000000000000001101010010001
11000001110101011111011110011
11110111 1110101 101111010001
11111111 1111111 111111111111
